cycle,opcode,color,x0,y0,x1,y1,start_pulse,busy
2,2,240,10,10,10,10,1,1
4,2,15,160,120,160,120,1,1
6,2,4095,319,239,319,239,1,1
8,2,255,400,300,400,300,1,1
11,3,3855,50,50,100,50,1,1
14,3,4080,100,50,100,100,1,1
17,3,255,20,20,80,80,1,1
20,3,3072,150,100,130,160,1,1
